#############
e..#.#...#..#
##.#.##.##.##
#....#..#...x
###.##.##.###
#...........#
#####.###.###
#...........#
...#.#...#..#
##.#.##.##.##
#....#..#....
###.##.##.###
#...........#
#####.###.###
#...........#
#############